OOOOOXOOOOOOOOOOOOOXOOOOOX
OOOOOXOOOOOOPOOOOCOXOOOOOX
OOOOOXOOOOOOXOOOOCOXOOOOOX
OOOOOXOOOCOX3XOOOOOXOOOOOX
OOOOOXOOOC3OOOOOOXOXOOOOOX
OOOOOXOCOO1OOOOO11OXOOOOOX
OOOOOXOCOXOOOOO133OXOOOOOX
OOOOOXOO1OOOOO13OOOXOOOOOX
OOOOOXOXOOOOO13OOOOXOOOOOX
OOOOOX1OOOOOO3OOOOOXOOOOOX
OOOOOX3OOOOOOOOOOOOXOOOOOX
OOOOOXOO1OOOOOOOOOOXOOOOOX
OOOOOXOO3OOOOOOOOOOXOOOOOX
OOOOOXOO1OOOOOOOOOOXOOOOOX
OOOOOXOOO1OOOOOOOOOXOOOOOX
OOOOOXOOO31OOOOOOOOXOOOOOX
OOOOOXOOOO3OOOOOOOOXOOOOOX
OOOOOXOOOOOOOFOOOOOXOOOOOX
OOOOOXOOOOOOXXOOOOOXOOOOOX
OOOOOX242424OO24242XOOOOOXX