OOOOOOOOOO2XOOOOX4OOOOOOOX
OOOOOOOOOO2XOOOOX4OOOOFOOX
OOOOOOOOOO2XOOOPX4OOO2XOOX
OOOOO1OO1O2X4OOXX4OOOOOOOX
COOOO3OO3O2XOOOOX4OOOOOOOX
COOOOCOOCO2XOOOOX4OOOXXOOX
COOOOCOOCO2XOOOOO4OOOOOOOX
OOOOOOOOOOO3OOO1OOOOOOOOOX
OOOOOOOOOOOOOXO3OOOOOOXOOX
OOXX4O2XOOOOOO1OOOOOOO3OOX
OOOOO1OO1OOO1O3OOOO1OOOOOX
OOOOO3OO31XX3OOOOOO3OOOXOX
OOOOOOOOO3OOOOOOOO1OOOOOOX
X4OOOOOOOOOOOOOOOO3OOOOOOX
OOOOOOO1OOOOOOOOOOOOO2XOOX
OOOOOOO3OOOOOOOOOOOOOOOOOX
OOOXOOOOOOOOCOO1OOOOXOOOOX
OOOOOOCOO2XXXOOXXXXOOOOOOX
OOOOOOXOOOOOOOOOOOOOOOOOOX
1111111111111111111111111XX