OOOOOOOOOOOOOOOOOOOOOOOOX
OOOOOOOOOOOOOOOOOOOOOOOOX
OOOOOOOOOOOOOOOOOOOOOOOOX
OOOOOOOOOOOOOOOOOOOOOOOOX
OOOOOOOOOOOOOOOOOOOOOOOCX
OOOOOOOOOOOOOOOOOOOOOOOOX
OOOOOOOOOOOOOOOOOOOOOOOOX
OOOOFOOOOOOOOOOOOOOOOOO1X
OOOXXXXXXXX4OOOCCOOCCOOXX
OOOOO3OOOOOOOOOXXXXXXOOOX
OOOOOOOOOOOOOOOOOOOOXXXXX
OOOOOOOOOOOOO1OOOOOOOOXXX
OOOOOOOOOOXXXXOOXXOOOOOOX
OOOOOXXOOOOOOOOOO3OOOOOOX
OOOOOOOOOOOOOOOOOOOOOOOOX
OXXXOOOOOOOOOOOCOOOOOOOOX
O3OOOOOOOOOOOOOOOOOOOPOOX
OOOOOOOOO1OOOOOOOOOOOOOOX
OOOOOOXXXXOOOO111OOOOOOOX
XXXXXXXXXXXXXXXXXXXXXXXXXXX