OOOOOOOOOOOOOOOOOOOOOOOOX
OOOOOOOOOOOOOOOOOOOOOOOOX
OOOOOOOOOOOOOOOOOOOOOOOOX
OOOOOOOOOOOOOOOOOOOOOOOOX
OOOOOOOOOOOOOOOOOOOOOOOOX
OOOOOOOOOOOOOOOOOOOOOOOOX
OOOOOOOOOOOOOOOOOOOOOOOOX
OOOOOOOOOOOOOOOOOOOOOOOFX
OOOOOOOOOOOOOOOOOOOOOOOXX
OOOOOOOOOOOOCOOOOOOOOOOOX
OOOOOOOOOOOOOOOOOOO2XXXXX
COOOOOOOOOOO1OOOOOOOOOOOX
COOOOCOOOOXXXXOOXXOOOOOOX
OOOOOXX4OOOOOOOOOOOOOOOOX
OOOOOOOOOOOOOOOOOOOOOOOOX
OXXXOOOOOOOOOOOOOOOOOO  X
OOO3OOOOCOOOPOOOOOOOOOOOX
OOOOOOCOOOCOOOOOOOOOOOOOX
OOOOOOOO1OOOOOOOOOOOOOOOX
XXXXXXXXXXXXXXXXXXXXXXXXXXX