OOOOOOOOOOOOOOOOOOOOOOOOOX
OOOOOOOOOOOOOOOOOOOOOOOOOX
OOOOOOOOOOOOOOOCOOOOOOOOOX
POOOOOOOOOOOOOOCO1OOOOOOOX
XXXXXXX4OOOO1OOOO3OOOOOOOX
OOOOO3OO242XXOOOO1OOOOOOOX
OOOOOOOOOOOOOOOOO3OOOOOOOX
OOOOOOOOOOOOOOOOO1OOOOOOOX
OCOOOOOOOOOOOOOOOXXOOOOOOX
OCOXOOOOOOOOOOOOOOOOOOOOOX
OOOOOXOOOOOOOO2X4OOOOOOOOX
OOOOOOOOOO1OOOOOOOOOOOOOOX
OOOO242XXXXOOOOOOOOOOOOOOX
OOOOOOOOOOXXOOOOOOOOOOOOOX
OOOOOOOOOOOOOOOOOOOOOOOOOX
OXXOOOOCOOOOOOOOOOOOOOOOOX
OOOOOOOOOFOOOOOOOOOOOOOOOX
OOOOOXXXXXOOOOOOOOOOOOOOOX
OOOOOOOOOOOOOOOOOOOOOOOOOX
1111111111111111111111111XX