OOOOOOOOOOOOXOOOOOOOOOOOOX
OOOOOOOOOOOOOOOOOOOOOOOOOX
OOOOOOOOOOOOOOOOOOOOOOOOOX
OOOOOOOOOOOOOOOOOOOOOOOOOX
OOOOOOOOOOOOOOOOOOOOOOOOOX
OOOOOOOOOOOOOOOOOOOOOOOOOX
OFOOOOOOOOOOOOOOOOOOOOOOOX
X4OOOOOOOOOOOOOOOOOOOOOOOX
OOOOOXOXOOOOOOOOOOOOOOOOXX
OOOOOOOOOOOOO1OOOOOOOOOOOX
OOOOOOOOOOOOOXOOOOOOOOOOOX
OOOOOOOOOOOOXXOOOCOOOOOOOX
OOOOOOOOOOOOOOOOOOOOOOOOOX
OOOOOOOOOOOOOOOOOOOOOOOOOX
OOOOOOOOOOOOOOOOOOOOOOOOOX
OOOOOOOOOXOOOOOOOOOOOOOOOX
OOOOOOOOOOOOOOOOOOOOOOOOOX
OOOOOOOOOOOOOOOOOOOOOOOOOX
OOOOOOOOOOOOPOOOOOOOOOOOOX
11111111111XXXXXXX1111111111